demur = raise objections or show reluctance [steve jobs : Because I assumed that he was still in the middle of an oscillating career that had many more ups and downs left, I demurred.]
abate = subside or moderate [Vocobo : They waited for the storm to abate]
aberrant = abnormal or deviant [Vocobo : Given the aberrant nature of data,we came to doubt]
abeyance = suspended action [Vovobo : The deal was held in abeyance]
abscond = depart secretly and hide [Vovobo : The teller absconded with the bonds and was not found]
abstemious = sparring diet [Vovobo : Concerned with son's abstemious diet ..]
admonish = warn,reprove [Vovobo : he admonished his listeners to .. ]
adulterate = adding impurity [Vovobo : It is a crime to adulterate food]
aesthetic = capable of aprreciating the beauty [Vovobo : The beauty of new born daughters teary eyes appealed to her aesthetic sense]
alacrity =  eagerness [Vovobo : hw demonstrated his eagerness to serve by his alacrity in executing .. ]
alleviate = relieve [Vovobo : this should alleviate the pain]
amalgamate = combine [Vovobo : The unions will attempt to amalgamate their groups into one national body]
ambiguous = doubtful [Vovobo : His ambiguous instructions misled us ]
ambivalence = having contradictory feelings  [Vovobo : she was confused by the ambivalence of her feelings ]
ameliorate = improve [Vovobo : We should try to amelioate the conditions of people living in the slums]
anachronism = something or someone misplaced in time [Vovobo : Shakespeares references to clocks in julius caseser is an anachronism ,no clocks existed in caesars time]
analogous = comparable [Vovobo : they saw the relationship between a ruler and his subjects as analogous to that of father and children ]
anarchy = absence of governing body [Vovobo :The assasination of leaders led to period of anarchy ]
anomalous = abnormal [Vovobo : Given the anomalous nature of data,we came to doubt]
antipathy = dislike,aversion [Vovobo : His extreme antipathy for dispute caused ..]
apathy = lack of caring [Vovobo : "widespread apathy among students" ]
appease = pacify,soothe [Vovobo : When we try to appease our enemies ,we encourage them to make additional demands]
apprise = inform [Vovobo : When he was apprised of the dangerous weather conditions ..]
approbation = approval [Vovobo : She waited for her parents approbation r[ nyt1 :arding nightout]
appropriate = acquire [Vovobo : Media.net got appropiated by chinese company]
arduous = hard,sternous [Vovobo : her arduous efforts had sapped(gradual weakining) her energy]
artless = honest [Vovobo : Amir khans artless comment dragged him into controversies ]
ascetic = self-denial,austere [Vovobo : We cannot understamd the ascetic life led by monks]
assiduous = diigent [Vovobo : Taj Mahal was build from assiduous labor]
assuage = ease [Vovobo : Your messages of cheer should assuage her suffering]
attenuate = make thin ,weaken [Vovobo : "her intolerance was attenuated by an unexpected liberalism"]
audacious = daring,bold [Vovobo :Crowed cheered as joker performed audacious activities ]
austere = strict,stern [Vovobo : His austere demeanour ..]
autonomous = self-governing [Vovobo : Vjti is an autonomous coll[ nyt1 :e]
aver = state confidently [Vovobo :I wish to aver that .. ]
banal = unoriginal ,copied [Vovobo : The new song from ayushman seem banal ]
belie =  contradict [Vovobo : His exterior demeanour belied his inate sensitivity]
beneficient = kindly [Vovobo : One has to curb their beneficient activities durint their financial crisis]
bolster = support,reinforce [Vovobo : Police has enough evidence to bolster their guess]
bombastic = high-sounding but with little meaning; inflated. [Vovobo : The orater spoke in an bombastic manner]
boorish = rude,insensitive [Vovobo : she was ignoring her husbands boorish behaviour]
burgeon = grow forth [Vovobo : plants that burgeon .. ]
burnish =  polish [Vovobo :He burnished his brass ornaments with .. ]
buttress = support [Vovobo : architects are trying to buttress the walls of temple]
cacophonous =  discordant mixture of sounds.  [Vovobo : "the cacophonous sound of slot machines"]
capricious = unpredictable [Vovobo : The storm was capricous]
castigation = severe critism,punishment [Vovobo : she could not bear castigation about her food]
catalyst = fastenning aggent [Vovobo :many chemical reactions are aided by catalyst ]
caustic = sarcastical biting [Vovobo : The critic's caustic remarks]
chicanery = trickery,deception [Vovobo : Her deceitful tactics in this case are indications of chicanery]


systematic = planned [nyt1:systematic rape of captives under medieval codes.]
captives = captured [ nyt1 :systematic rape of captives under medieval codes.]
nightfall = time of sunset(night is starting) [ nyt1 :nightfall started the countdown to her next rape]
dreading = To fear greatly [ nyt1 :she spent her days dreading  the smell of the ISIS fighter’s breath.]
to inflict = to impose [ nyt1 :pain he inflicted on her body.]
tormented = To cause severe suffering to (stronger than to vex (anoyed) but weaker than to torture.)[ nyt1 : she was tormented by the thought]
injunction = The act of enjoining; the act of directing, commanding, or prohibiting.[ nyt1 :It is a particularly modern solution to a medieval injunction]
obscure = Dark, faint or indistinct(difficult to understand).[ nyt1 : :According to an obscure ruling in Islamic law cited by the Islamic State]
cited = To quote; to repeat[ nyt1 : :According to an obscure ruling in Islamic law cited by the Islamic State]
unabated = without any reduction in intensity or strength. [ nyt1 :fighters have aggressively pushed birth control on their victims so they can continue the abuse unabated while the women are pass+ed among them.]
apprehension = The physical act of seizing or taking hold of; seizure. [ nyt1 :They awaited their results with apprehension]
assaulted = To attack, threaten or harass. [ nyt1 :women describing being assaulted by men who were either ignorant of the injunction or defiant of it.]
defiant = Defying(Boldly resisting opposition)[nyt1 :"a defiant gesture"]
sought= To try to find, to look for [ nyt1 :ethnic group who have sought treatment]
demeanor = The social, non-verbal behaviors (such as body language and facial expressions) that are characteristic of a person. [ nyt1 : M., has the demeanor of a child and wears her hair in a bouncy ponytail.]
prospective = Likely or expected to happen or become. [ nyt1 :When prospective buyers came]
to unnerved= To upset. [ nyt1 : unnerved by what he perceived as a delay]
perceived = To see, to be aware of, to understand.[ nyt1 : unnerved by what he perceived as a delay]
massif = A principal mountain mass. [ nyt1 : now living in tents in the plains of the yellow massif]
abstinence = The practice of self-denial; self-restraint; forbearance from anything. [ nyt1 : eg1: respecting a period of sexual abstinence whenever the captive changes hands ,eg2: I started drinking again after six years of abstinence]
circumvent = to bypass [ nyt1 :to circumvent the waiting period.]
hew = conform or adhere to. [ nyt1 :Although it remains unclear why some hewed closely to the regulations while others flouted them]
flouted = To express contempt for the rules by word or action.[ nyt1 :Although it remains unclear why some hewed closely to the regulations while others flouted them]
triumphantly = something done in a victorious or proud manner. [ nyt1 : The fighter’s mother triumphantly told her son]
overseeing = To survey, look at something in a wide angle [ nyt1 : the physician tasked with overseeing the treatment of the hundreds of victims]
returnees = Someone who comes back or returns, especially to one's own country or region. [ nyt1 :treating the returnees, he said. “There were no signs.”]
deemed=to judge [ nyt1 :"the event was deemed a great success"]
chaperone = a person who accompanies and looks after another person or group of people. [ nyt1 :she was asked to chaperone a group of young Yazidi women]
nauseated = Having a feeling of nausea. [ nyt1 :  H. began to feel nauseated soon after her abduction]
drugged= drugs taken [ nyt1 :when he did he appeared drugged.]
imploring = To beg urgently or earnestly. [ nyt1 :instead imploring her to ask for the procedure herself.]

reeling = To spin or revolve repeatedly. [nyt2 :reeling from Edward J. Snowden’s disclosure]
disclosure = revealing [nyt2 :"a judge ordered the disclosure of the government documents"]
wrenching = The act by which something is wrenched(pull or twist suddenly and violently.). [nyt2 :vigorous public debate about the wrenching trade-offs between safeguarding personal privacy and tracking down potential terrorists]
stark = Hard, firm; obdurate(stubbornly refusing to change one's opinion or course of action.) [nyt2 :The trade-offs seem particularly stark because they have been framed around a simple question: Should Apple help the F.B.I. hack into an iPhone used by a gunman in the massacre last December in San Bernardino, Calif.?]
adamant = Firm; unshakeable; unyielding; determined.[nyt2: "he is adamant that he is not going to resign" ]
lampooned = To satirize or poke fun at.[nyt2 : Late-night comedians have lampooned government snoopers.]
terse = Brief, concise, to the point.[nyt2 :After exchanging several terse messages, they agreed to disagree.]
fetishizing = To obsess over [nyt2: fetishizing our phones above every other value.]
anxious = Full of anxiety or disquietude; greatly concerned or solicitous,[nyt2: "she was extremely anxious about her exams"]
garnered = gather it up [nyt2 :case already seems to have garnered more public attention]
visceral = Having deep sensibility. [nyt2 :Everyone gets at a really visceral level that you have a lot of really personal stuff on this device]
wonks = intellectual expert (about policy).[nyt2:"any kid with an interest in science was a wonk" ]
angst = Emotional turmoil; painful sadness. [nyt2 : public angst about the iPhone case feels more urgent]


Mayday=Mayday is an emergency procedure word used internationally as a distress signal in voice procedure radio communications.[nyt3 =Mayday on queen carolina(boat)]
scallop boat=Any boat catching shimpla type species[nyt3 = Any of various marine bivalve molluscs of the family Pectinidae which are free-swimming.]
barreling=To move quickly or in an uncontrolled manner.[nyt3 =A powerful storm system  was barreling down on them.]
demarcation=The act of marking off a boundary or setting a limit[nyt3 = past a predetermined demarcation line that would stop the clock on their allotted 32-day yearly limit at sea.]
haul=pull or drag with effort or force.[nyt3 =this trip was the crew’s last chance for a major haul.]
battered=to hit violently and repeatedly.[nyt3 = "he finished the day battered and bruised"]
treacherous=dangerous[nyt3 =This was a very treacherous operation]
crumbling=to fall apart[nyt3 = "the plaster started to crumble"]
contingencies=of happening by chance[nyt3 = "a detailed contract which attempts to provide for all possible contingencies"]
capsized=to overturn[nyt3 =the boat capsized in the rough waters near East Rockaway]
conjure=majic trick[nyt3 =Scallop fishing may not conjure up the derring-do of those catching crabs ]
derring-do=Brave and adventurous (albeit often reckless) actions[nyt3 ="tales of derring-do"]
scoured=To search an area thoroughly.[nyt3 =The huge tows scouring the ocean bed for scallops dredge for about 50 minutes and are then hauled up]
dredge=Any instrument used to gather or take by dragging[nyt3 = "the lower stretch of the river had been dredged"]


Ebbs=gradually decrease.[nyt4 :His life is gradually ebbing.]
Surge=the rate of change of acceleration in physics.[nyt4 : "the journalists surged forward"]
slump=A heavy or helpless collapse[nyt4 : While the reasons vary — including the long slump in personal computer sales and slipping prices for online ads ]
embroiled=  To draw into a situation   [nyt4 :The company has been embroiled in a well-publicized battle with the federal government ]


grappled=to ponder and intensely evaluate a problem; normally used with "with".[nyt5 : For all the issues that Twitter has grappled with over the last few years]
modest=Small, moderate in size.[nyt5 :The number of people joining the service continues to be modest]
lure=attract[nyt5 : even after a battery of experiments by the company to lure new users.]
plunged=To cast or throw into something, state, condition or action.[nyt5 :Twitter’s stock has plunged about 65 percent]
intent=Firmly fixed or concentrated on something.[nyt5 :though he said he was intent on improving Twitter]
caveat=warning[nyt5 :But those figures come with a caveat.]
lucrative=Producing a surplus; profitable.[nyt5 :less financially lucrative for Twitter.]


vaunt=boast about or praise (something), especially excessively[nyt6 : managed to bypass the company’s vaunted encryption.]
sparring=make the motions of boxing without landing heavy blows, as a form of training[nyt6 : After two months of tense sparring over the San Bernardino iPhone,]
rebuke=express sharp disapproval or criticism of (someone) because of their behaviour or actions.[nyt6 : the government’s decision was a clear rebuke to Apple.]
divulge=make known (private or sensitive information).[nyt6 : The F.B.I. on Wednesday appeared eager to return the favor by refusing to divulge how it finally broke in]
thwart=prevent (someone) from accomplishing something.[nyt6 : Disclosing a vulnerability can mean that we forgo an opportunity to collect crucial intelligence that could thwart a terrorist attack]
adversaries= one's opponent in a contest, conflict, or dispute.[nyt6 :  that are being used by hackers or other adversaries to exploit our networks]


affiliated=officially attached or connected to an organization.[nyt7 : American forces have launched more than 8,800 strikes against the Islamic State in Iraq and Syria and hit the group’s affiliate in Libya]
bluntly=speaking in a direct and honest way, even if this offends or upsetspeople[nyt7 :  ‘They just don’t like you,’ he told me bluntly.]
precedent  = an action or event in the past that is used as an example or reason for a present action or event[nyt7 : but the approach his administration is taking sets the precedent for just that]
entrust=to give someone responsibility for an important job or activity[nyt7 : ..to Americans — is simply too important to entrust to a single branch of government.]


disparities=a great difference.[ nyt8 : highlighting the pay disparities between those of different genders doing the same job]
diversify=make or become more diverse or varied.[ nyt8 : are starting an effort to collect and share data to help diversify the rank-and-file employees who make up tech companies.]
grapple=engage in a close fight or struggle without weapons [ nyt8 : in Silicon Valley as tech companies grapple with criticism over the makeup]
ouster=dismissal or expulsion from a position.[ nyt8 :  Ms. Pao, for one, was in the headlines last year for her court case against Kleiner Perkins, as well as her ouster as interim chief executive of Reddit]
spurring=urge (a horse) forward by digging one's spurs into its sides.[ nyt8 : in the hope of spurring the companies to think about equality sooner rather than later.eg2:But that has not seemed to spur much movement in views on the issue.]
cohort=a group of people with a shared characteristic. [ nyt8 : Project Include aims to have 18 companies as part of its first cohort]
meritocracy=government or the holding of power by people selected according to merit. [ nyt8 : Despite an avalanche of rigorous data to the contrary, the belief in pure meritocracy persists.]
disenfranchised=deprive (someone) of the right to vote. [ nyt8 : Ms. Pao became something of a magnet for women who were disenfranchised with inequality issues in tech]


articulated=having two or more sections connected by a flexible joint.[nyt9 : has grown out of the “Third Offset”strategy articulated by Mr. Carter last fall.]
delineate=indicate the exact position of (a border or boundary).[nyt9 :I’m not as confident that we can clearly delineate between offensive and defensive weapons, in general]
skepticism=Skepticism or scepticism (see spelling differences) is generally any questioning attitude towards unempirical knowledge or opinions/beliefs stated as facts, or doubt regarding claims that are taken for granted elsewhere.[nyt9 :Despite skepticism among some in the tech community]
convoy=(of a warship or armed troops) accompany (a group of ships or vehicles) for protection.[nyt9 :where a human soldier could sit in the driver’s seat in the last vehicle in a truck convoy, safely controlling a series of vehicles]
cachet=the state of being respected or admired; prestige.[nyt9 :Mr. Carter’s background could provide him with cachet among Silicon Valley’s tech elite. ]
lingo=the vocabulary or jargon of a particular subject or group of people.[nyt9 :Borrowing a bit of tech industry lingo, he said the Pentagon planned to create additional organizations]
mull=think about (something) deeply and at length.[nyt9 : big thinkers at the company were mulling things like cloud computing]


looming=(of an event regarded as ominous or threatening) seem about to happen. "there is a crisis looming" [nyt10 :artificial intelligence presents a looming existential threat to humanity]
luminaries=a person who inspires or influences others, especially one prominent in a particular sphere. [nyt10 :Warnings by luminaries like Elon Musk and Nick Bostrom about “the singularity]
wring= squeeze and twist (something) to force liquid from it [nyt10 :But this hand-wringing is a distraction from the very real problems with artificial intelligence today,which may already be exacerbating inequality in the workplace, at home and in our legal and judicial systems]
exacerbating=make (a problem, bad situation, or negative feeling) worse.[nyt10 : "rising inflation was exacerbated by the collapse of oil prices"]
recidivism =Recidivism is one of the most fundamental concepts in criminal justice. It refers to a person's relapse into criminal behavior, often after the person receives sanctions or undergoes intervention for a previous crime. [nyt10 :It found that widely used software that assessed the risk of recidivism in criminals was twice as likely to mistakenly flag black defendants as being at a higher risk of committing future crimes]
relapse=(of someone suffering from a disease) suffer deterioration after a period of improvement.[nyt10 :"two of the patients in remission relapsed after 48 months"]
perpetuating=make (something, typically an undesirable situation or an unfounded belief) continue indefinitely.[nyt10 :this software risks perpetuating an already vicious cycle, in which the police increase their presence in the same places they are already policing]
vicious=deliberately cruel or violent.[nyt10 : "a vicious assault"]
vigilant=keeping careful watch for possible danger or difficulties. [nyt10 :We need to be vigilant about how we design and train these machine-learning systems]
stereotypes=a widely held but fixed and oversimplified image or idea of a particular type of person or thing."the stereotype of the woman as the carer" [nyt10 :we risk constructing machine intelligence that mirrors a narrow and privileged vision of society, with its old, familiar biases and stereotypes.]
implications=the conclusion that can be drawn from something, although it is not explicitly stated. [nyt10 :we must address the current implications for communities that have less power]
affluent=(especially of a group or area) having a great deal of money; wealthy. [nyt10 :Currently the loudest voices debating the potential dangers of superintelligence are affluent white men, and, perhaps for them, the biggest threat is the rise of an artificially intelligent apex predator.]

