Shackled =chained [shantaram : I realised, somehow, through the screaming in my mind, that even in that shackled, bloody helplessness, I was still free ]
Flinch = make a quick, nervous movement of the face or body as an instinctive reaction to fear or pain. [shantaram : But in the flinch and bite of the chain, when it’s all you’ve got, that freedom is a universe of possibility.]
Umbilical = relating to or affecting the navel or umbilical cord. [shantaram : I walked along the umbilical corridor that connected the plane to the airport. ]
Clung= hold on tightly to. [shantaram : not five minutes from the conditioned air of the plane, and my clothes clung to sudden sweat]
Thumped =hit or strike heavily  [shantaram : My heart thumped under the command of the new climate. ]
camouflage = the disguising of military personnel, equipment, and installations by painting or covering them to make them blend in with their surroundings.  [shantaram : To camouflage themselves, when using false passports and identification papers, smugglers insinuate themselves into the company of fellow travellers ]
insinuate= suggest or hint (something bad) in an indirect and unpleasant way. [shantaram : To camouflage themselves, when using false passports and identification papers, smugglers insinuate themselves into the company of fellow travellers  ]
Guileless= innocent  [shantaram : The various Indian officials assumed that I was travelling with that relaxed and guileless group, and gave me no more than a cursory check. ]
trot=  run at a moderate pace with short steps.  [shantaram : 'Welcome in India,’ he said, and trotted away into the forest of bodies on the path. ]
nonchalant= feeling or appearing casually calm and relaxed; not displaying anxiety, interest, or enthusiasm. [shantaram : I watched as my backpack and travel bag were lifted to the top of a bus, and dumped onto a pile of luggage with precise and nonchalant violence ]
scowl =frown in an angry or bad-tempered way. [shantaram : the driver turned in his seat, scowled at us menacingly  ]
menacing = suggesting the presence of danger; threatening.  [shantaram : the driver turned in his seat, scowled at us menacingly ]
limp = walk with difficulty, typically because of a damaged or stiff leg or foot [shantaram : we sped off at alarming speed through crowds of porters and pedestrians who limped, sprang, or side-stepped out of the way with only millimetres to spare. ]
Spring = move or jump suddenly or rapidly upwards or forwards. [shantaram : we sped off at alarming speed through crowds of porters and pedestrians who limped, sprang, or side-stepped out of the way with only millimetres to spare. ]
animosity = antipathy  [shantaram : Our conductor, riding on the bottom step of the bus, cursed them with artful animosity. ]
lull = calm or send to sleep, typically with soothing sounds or movements  [shantaram : The familiarity lulled me into a complacency that was so profoundly shattered, at the first narrowing of the road  ]
talon = a claw, especially one belonging to a bird of prey. [shantaram : For the first sight of the slums, as the many lanes of the motorway became one, and the trees disappeared, clutched at my heart with talons of shame. ]
Cindered = part of ash [shantaram : It seemed impossible that a modern airport, full of prosperous and purposeful travellers, was only kilometres away from those crushed and cindered dreams ]
Writhed = make twisting, squirming movements or contortions of the body. [shantaram : As the kilometres wound past, as the hundreds of people in those slums became thousands, and tens of thousands, my spirit writhed ]
Defile = damage the purity or appearance of; mar or spoil [shantaram : I felt defiled by my own health and the money in my pockets ]
Lacerating = tear or make deep cuts in (flesh or skin). [shantaram :it’s a lacerating guilt, that first confrontation with the wretched of the earth ]
Wretched= poor state [shantaram : it’s a lacerating guilt, that first confrontation with the wretched of the earth]
smoulder = burn slowly with smoke but no flame. [shantaram : Then the smoulders of shame and guilt flamed into anger ]
affluent = (especially of a group or area) having a great deal of money; wealthy. [shantaram : But the slums went on, kilometre after kilometre, relieved only by the awful contrast of the thriving businesses and crumbling, moss-covered apartment buildings of the comparatively affluent]
piety = the quality of being religious or reverent. [shantaram : "acts of piety and charity" ]
stoop = bend one's head or body forwards and downwards. [shantaram : A woman stooped to brush forward the black satin psalm of her hair. ]
ethereal = extremely delicate and light in a way that seems not to be of this world.  [shantaram : the women wrapped in crimson, blue, and gold; the women walking barefoot through the tangled shabbiness of the slum with patient, ethereal grace ]
camaraderie = mutual trust and friendship among people who spend a lot of time together.  [shantaram : the affectionate camaraderie of the fine-limbed children ]
Crummiest = dirty, unpleasant, or of poor quality. [shantaram : This here is the crummiest city in India, y’can take my word. ]
vague = of uncertain, indefinite, or unclear character or meaning. [shantaram : Two pairs of clear, pale-blue eyes stared at me with the vague ]
accusatory = indicating or suggesting that one believes a person has done something wrong. [shantaram : Two pairs of clear, pale-blue eyes stared at me with the vague, almost accusatory censure of those who’ve convinced themselves that they’ve found the one true path. ]
strew = scatter or spread (things) untidily over a surface or area. [shantaram : A small colony of black, ragged slum huts was strewn upon those rocks like the wreckage of some dark and primitive ship ]
rev =increase the running speed of (an engine) or the engine speed of (a vehicle) by pressing the accelerator  [shantaram : The bus driver slowed with other traffic to look at the fire, but then revved the engine and drove on ]
char = partially burn so as to blacken the surface. [shantaram : I turned to look through the rear window of the bus until the charred humps of the huts became minute specks ]
liveried  = wearing a special uniform  [shantaram :There were grand hotels, with liveried doormen standing beneath coloured awnings ]
plodding = slow-moving and unexciting [shantaram : The impression was of a plodding, indefatigable, and distant past that had crashed intact, through barriers of time, into its own future. ]
exuberance = the quality of being full of energy, excitement, and cheerfulness; ebullience. [shantaram :There was something in the disk of his smile - a kind of mischievous exuberance ]
fractious = irritable and quarrelsome. [shantaram : The little guide grabbed my sleeve to lead me away from the fractious group ]
shrug = raise (one's shoulders) slightly and momentarily to express doubt, ignorance, or indifference. [shantaram : I’ll pay him,’ I told my companions. They shrugged, and lifted their packs  ]
trundle =  move or cause to move slowly and heavily. [shantaram : The pack was heavy, forcing him to thrust his neck out, lean over, and launch himself forward into a trundling gait.  ]
gait = a person's manner of walking. [shantaram : The pack was heavy, forcing him to thrust his neck out, lean over, and launch himself forward into a trundling gait.  ]
Amaible = showing pleasant [shantaram : He spoke with deferential amiability to the two Canadians. ]
faltered = lose strength or momentum. [shantaram : he never paused or faltered in his step throughout the fifteen-minute journey to the hotel.]
mossy = old-fashioned or extremely conservative. [shantaram : Four steep flights in a dark and mossy well of stairs]
foyer = an entrance hall or other open area in a building used by the public, especially a hotel or theatre. [shantaram : brought us to the foyer of the India Guest House]
tumbled = all suddenly, clumsily, or headlong. [shantaram :I tumbled into the small foyer with our bags and packs ]
flaking = come or fall away from a surface in flakes. [shantaram : looking around him at the flaking paint and laminated wooden partitions.]
interjected = say (something) abruptly, especially as an aside or interruption. [shantaram : ‘This is Mr. Anand,’ Prabaker interjected quickly. ]
growl = say something in a low harsh voice, typically in a threatening manner. [shantaram : ‘Shut up, Prabaker!’ Mr. Anand growled.]
snap = break suddenly and completely, typically with a sharp cracking sound. [shantaram : ‘I told you to shut up!’ Anand snapped.]
anguished = experiencing or expressing severe mental or physical pain or suffering. [shantaram : Prabaker stopped them with an anguished cry.]
plead = make an emotional appeal. [shantaram : He wasn’t going to plead with us ]
persuade = induce (someone) to do something through reasoning or argument. [shantaram : He wasn’t going to plead with us, or persuade us to take the room.]
lumps = a compact mass of a substance, especially one without a definite or regular shape. [shantaram : The cement floor sloped downwards, with mysterious lumps]
undulations = a gentle rising and falling in the manner of waves [shantaram :The cement floor sloped downwards, with mysterious lumps and irregular undulations, toward the street windows.]
forlorn = pitifully sad and abandoned or lonely. [shantaram : and two forlorn, shrivelled balloons hanging from the ceiling fan.]
scurrying =  move hurriedly with short quick steps. [shantaram :‘Yes!’ Prabaker cried, scurrying away at once toward the foyer.]
gingerly = in a careful or cautious manner. [shantarm : He bent low and sniffed at the sheets before sitting down gingerly on one of the beds.]
lingered = stay in a place longer than necessary because of a reluctance to leave. [shantaram : Anand gave the others their passports, but lingered with mine, tapping it against his cheek thoughtfully.]
frown = disapprove of. [shantaram : ‘So?’ I frowned, wondering if he’d seen or sensed something. ]
cringed = bend one's head and body in fear or apprehension or in a servile manner. [shantaram : The guide cringed away from him in the doorway]
ledge = a narrow horizontal surface projecting from a wall,  cliff, or other surface. [shantaram : There was a ledge on the windowsill, and I began to place my keepsakes]
distraught = very worried and upset. [shantaram : ‘No problem dying, baba,’ Prabaker soothed, offering the distraught Canadians his neatly rolled joint.]
talisman = an object, typically an inscribed ring or stone, that is thought to have magic powers and to bring good luck. [shantaram : my whole life was held in memories, talismans, and pledges of love.]
gluging = pour or drink (liquid) with a hollow gurgling sound. [shantaram : He drank again, glugging the liquor down in throat-bulging gulps]
crumpled =  suddenly flop down to the ground. [shantaram : his smile crumpled into a stricken expression.]
anew = in a new or different and typically more positive way. [shantaram : The smile shone anew ]
filthy = disgustingly dirty. [shantaram : the street was filthy]
roistering = enjoy oneself or celebrate in a noisy or boisterous way. [shantaram : Prabaker led me on through the roistering crowd]
slouch = stand, move, or sit in a lazy, drooping way. [shantaram : The haphazard slouch of neglected tenements crumbled into lavish displays of market vegetables and silks.]
exhilaratingly = cheerfully [shantaram :Bombay was free—exhilaratingly free]
fugitive = a person who has escaped from captivity or is in hiding. [shantaram : I was a fugitive]
baksheesh = a small sum of money given as alms, a tip, or a bribe. [shantaram : they only have to pay the police half of usual baksheesh money.]
dexterous = showing or having skill, especially with the hands. [shantaram : The many customers crowded around his stall purchased the leaves as fast as his dexterous hands could fill them]
Craning = stretch out one's body or neck in order to see something. [shantaram : Craning my neck to watch him through the thicket of customers]
stride = walk with long, decisive steps in a specified direction. [shantaram : The bus would’ve killed me if those hands hadn’t halted me in my stride]
primed = make (something) ready for use or action, in particular: [shantaram :The clue to everything a man should love and fear in her was there, right from the start, in the ironic smile that primed and swelled the archery of her full lips]
impassivity = apathy demonstrated by an absence of emotional reactions [shantaram : and confuse her confidence with impassivity]
shimmering = shine with a soft, slightly wavering light. [shantaram : My eyes were lost, swimming, floating free in the shimmering lagoon of her steady, even stare.]
wry =  twisted into an expression of disgust, disappointment, or annoyance. [shantaram : ‘I’m afraid not,’ she replied, her cheeks dimpling with a wry smile.]
sonorous =  imposingly deep and full. [shantaram : Her voice, in that language and in that conversation, was surprisingly deep and sonorous]
smouldering = burn slowly with smoke but no flame. [shantaram : He leaned forward and took up a length of smouldering hemp rope ]
hemp = the cannabis plant, especially when grown for fibre.[shantaram : He leaned forward and took up a length of smouldering hemp rope]
inscrutable = impossible to understand or interpret.[shantaram : She was so relaxed and at home, so much a part of the street and its inscrutable lore.]
lore = a body of traditions and knowledge on a subject or held by a particular group, typically passed from person to person by word of mouth. [shantaram :She was so relaxed and at home, so much a part of the street and its inscrutable lore.]
mundane = lacking interest or excitement; dull. [shantaram : What I found bewildering, all around me, seemed to be mundane for her.]
abashed. = make (someone) feel embarrassed, disconcerted, or ashamed. [shantaram : ‘Oh, I am understand,’ he said, looking abashed.]
mused = be absorbed in thought. [shantaram : ‘You know,’ he mused, frowning hard for the first time]
defiance = open resistance; bold disobedience.[shantaram : Karla joined them, walking away with her head held high in that curiously straight-backed, almost defiant posture.]
fatalism = the belief that all events are predetermined and therefore inevitable. [shantaram : I’d found myself reacting with a quirky fatalism to the new names I was forced to adopt, in one place or another, and to the new names that others gave me.]
diminutive = extremely or unusually small. [shantaram : Lin. It was a diminutive I never could’ve invented for myself.]
sheaf = a bundle of grain stalks laid lengthways and tied together after reaping. [shantaram : He took a sheaf of rupee notes from his shirt pocket, peeled off a number, and passed them]
suffusion = when something slowly spreads throughout something else [shantaram : Within seconds, a suffusion of aromatic sweetnesses possessed my mouth.]
luscious =  having a pleasingly rich, sweet taste. [shantaram : The taste was sharp and luscious]
piquant = having a pleasantly sharp taste or appetizing flavour. [shantaram :The taste was sharp and luscious-honeyed and subtly piquant at the same time]
impish = inclined to do slightly naughty things for fun; mischievous.[shantaram : He glanced at me, his cheeks appled in the impish grin]
sombre = dark or dull in colour or tone. [shantaram :The smile sparked his eyes, but his voice was surprisingly sombre]
endearing = inspiring affection. [shantaram : It was at once his most endearing and most irritating quality]
sultry = very hot and humid. [shantaram : Beneath my windows the street that had writhed and toiled in daylight was silent, subdued by a night-sultriness, moist with stars. ]
subdued = quiet and rather reflective or depressed. [shantaram :  Beneath my windows the street that had writhed and toiled in daylight was silent, subdued by a night-sultriness, moist with stars. ]
callousness = insensitive; indifferent; unsympathetic [shantaram : I decided, with the faint, impersonal callousness of the lonely, that if he were as good as his word, and turned up in the morning, I would begin to like him.]
mercenary = primarily concerned with making money at the expense of ethics. [shantaram : The Indians in the cities are real mercenary, man.]
haggling = dispute or bargain persistently, especially over the cost of something. [shantaram :We could’ve saved a dollar or two per day. And haggling is the economical thing to do.]
endeared = cause to be loved or liked. [shantaram : The fact that I trusted him on sight and didn’t haggle, on that first day, that I didn’t try to make a buck out of him, that I worked on an instinct that respected him and was prepared to like him, endeared me to him.]



foliant = a sheet of any written or printed material  [shantaram : I tried once more to find the words for the foliant blaze of her green eyes.]
Helvetian = Swiss [shantaram : I liked the Helvetian music of her Swiss-American English]
assail = (of an unpleasant feeling or physical sensation) come upon (someone) suddenly and strongly. [shantaram : I liked the way she held my eyes until the precise moment when it stopped being comfortable, and then smiled, softening the assail, but never looked away]
repression = the action of subduing someone or something by force. [shantaram : But repression, they say, breeds resistance in some men, and I was resisting the world with every minute of my life.]
ruffling = disorder or disarrange (someone's hair), typically by running one's hands through it. [shantaram : ruffling my hair with one hand as she sat down at my table.]
bristled = be covered with or abundant in. [shantaram : and the sudden wariness that bristled in the single word of her question surprised me]
chided = scold or rebuke [shantaram : ‘You didn’t hear a word we said,’ she chided.]
wad = a mass or lump of a soft material, used for padding, stuffing, or wiping. [shantaram : lumpy wads of flesh and deep lines that gave him the plump and careworn look of a much older man ]
careworn = tired and unhappy because of prolonged worry. [shantaram : lumpy wads of flesh and deep lines that gave him the plump and careworn look of a much older man ]
stubble = short, stiff hairs growing on a man's face when he has not shaved for a while. [shantaram : the stubble on his tired face never seemed to be less than three days from its last shave ]
indolent = wanting to avoid activity or exertion; lazy. [shantaram : using the language to provoke and criticise friend and stranger alike with an indolent malignity ]
malignity =  intense ill will; [shantaram: using the language to provoke and criticise friend and stranger alike with an indolent malignity ]
resented = feel bitterness or indignation at (a circumstance, action, or person). [shantaram: There were people who resented his rudeness and rebukes]
churlishness = marked by a lack of civility or graciousness  [shantaram:  The churlishness of Leopold’s waiters was legendary.]
lapse = a brief or temporary failure of concentration, memory, or judgement. [shantaram : No!’ he laughed, ‘But I forgive you for the lapse.]
swished = move with a hissing or rushing sound. [shantaram: he swished a grimy rag over the wet surface of the table ]
adroit = clever or skilful. [shantaram : smiling with adroit but passionless coquetry. ]
coquetry = flirtatious behaviour. [shantaram: smiling with adroit but passionless coquetry. ]
despair = the complete loss or absence of hope. [shantaram: putting my life into words, every day, helped me to cope with shame and its first cousin, despair.]
pouting = push one's lips or one's bottom lip forward as an expression of petulant annoyance or in order to make oneself look sexually attractive. [shantaram: ‘I have a job,’ Ulla announced, pouting winsomely.]
leers = look or gaze in a lascivious or unpleasant way. [shantaram: She walked out after Modena, followed by leers and admiring stares from many]
mockery = teasing and contemptuous language or behaviour directed at a particular person or thing. [shantaram: She gave me a little smile, with one eyebrow raised in irony or mockery or both.]
clamorous = making a loud and confused noise. [shantaram:and let the activity of Leopold’s and its clamorous patrons close over me]
patron = a customer of a shop, restaurant, etc., especially a regular one. [shantaram: and let the activity of Leopold’s and its clamorous patrons close over me]
ogle = stare at in a lecherous manner. [shantaram: the chance to inspect, admire, and ogle others]
swarm = a large or dense group of flying insects. [shantaram :A swarm of broad fans buzzed in the high ceiling]
frantic = conducted in a hurried, excited, and disorganized way. [shantaram:one corner of the frantic kitchen was occasionally visible]
sumptuous = splendid and expensive-looking. [shantaram: A faded but still sumptuous elegance struck and held the eyes of all]
oasis = a fertile spot in a desert, where water is found. [shantaram: Leopold’s was an oasis of quiet in the struggling city.]
scrupulously = in a very careful and thorough way. [shantaram: Leopold’s was an unofficial free zone, scrupulously ignored by the otherwise efficient officers]
impudent = not showing due respect for another person; impertinent. [shantaram: The traders in the street stalls outside sold counterfeits of Lacoste, Cardin, and Cartier with a certain impudent panache]
panache = flamboyant confidence of style or manner. [shantaram:The traders in the street stalls outside sold counterfeits of Lacoste, Cardin, and Cartier with a certain impudent panache]
indignantly = in a manner indicating anger or annoyance at something perceived as unfair. [shantaram: ‘You think I’m joking?’ Didier puffed indignantly.]
plump = having a full rounded shape. [shantaram: He lifted his plump,jovial face above the heads of his friends ]
jovial = cheerful and friendly. [shantaram: He lifted his plump,jovial face above the heads of his friends ]
gleaming = shine brightly, especially with reflected light. [shantaram: he grinned, his blue eyes gleaming through lenses of pink, alcoholic wetness.]
brooding = engaged in or showing deep thought about something that makes one sad, angry, or worried. [shantaram: staring at it with a brooding, pensive expression.]
pensive = engaged in, involving, or reflecting deep or serious thought. [shantaram: staring at it with a brooding, pensive expression.]
sneering = smile or speak in a contemptuous or mocking manner. [shantaram: he replied, sneering cynically as he ticked each characteristic off]
cynically = in a distrustful way that expresses a belief that people are motivated purely by self-interest. [shantaram: he replied, sneering cynically as he ticked each characteristic off]
confided = tell someone about a secret or private matter while trusting them not to repeat it to others. [shantaram: ‘Ah, it is not only brown sugar and hashish that comes from Afghanistan into India,’ he confided]
flippant = not showing a serious or respectful attitude. [shantaram: I muttered, perhaps sounding more flippant than I’d intended]
purr = speak in a low, soft voice, especially when expressing contentment or acting seductively. [shantaram: ‘Ah, Karla ...’ He said her name with a long, purring roll.]
inscrutable = impossible to understand or interpret. [shantaram: And just what are your intentions with our inscrutable Karla?]
hysterical = affected by or deriving from wildly uncontrolled emotion. [ sh :It was a peculiarly high-pitched laugh, harsh and almost hysterical.]
commendation = formal or official praise. [ sh : even if a commendation from me is a very fragile endorsement]
debilitating = making someone very weak and infirm. [ sh : even his fondness for alcohol, exaggerated into what seemed to be a debilitating addiction]
nuanced = characterized by subtle shades of meaning or expression. [ sh :they were all expressions of an image he cultivated, and were as carefully nuanced as a professional actor’s]
slender = gracefully thin [ sh : two slender hands pressed together in prayer.]
mooring = the ropes, chains, or anchors by or to which a boat, ship, or buoy is moored. [ sh :the dark water starred by the moorage lights of a hundred ships at anchor.]
Simoom = a hot, dry, dust-laden wind blowing in the desert, especially in Arabia. [ sh : Arabian Sea brought occasional sprays over the waist-high stone wall: mists that swirled, on the Simoom,]
outrageous = shockingly bad or excessive. [ sh : even if he is an outrageous liar.]
decadence = moral or cultural decline as characterized by excessive indulgence in pleasure or luxury.[ sh : At least he makes no secret of his decadence]
Hypocrisy = the practice of claiming to have higher standards or more noble beliefs than is the case.[ sh :Hypocrisy is just another kind of cruelty.]
despises = feel contempt or a deep repugnance for. [ sh : Didier despises them, and he restricts himself to affairs with foreigners.]
hunker = squat or crouch down low. [ sh :The thin, grey animal hunkered down and scowled]
wizened = shrivelled or wrinkled with age. [ sh :It was a wizened and scabrous specimen]
scabrous = rough and covered with, or as if with, scabs.  [ sh :It was a wizened and scabrous specimen]
feral = n a wild state, especially after escape from captivity or domestication. [ sh :I found it amazing that such a feral, emaciated creature should permit itself to be petted ]
emaciated = abnormally thin or weak, especially because of illness or a lack of food. [ sh :I found it amazing that such a feral, emaciated creature should permit itself to be petted ]
coo =  speak in a soft gentle voice. [ sh :‘Oh, look at him,’ she cooed.]
pry  = enquire too inquisitively into a person's private affairs. [ sh :‘How does she live? I don’t mean to pry]
pirouette = an act of spinning on one foot, typically with the raised foot touching the knee of the supporting leg. [ sh :he reached the centre of the deserted road, wheeling to a stop with a dramatic pirouette]
consummate  = showing great skill and flair. [ sh :He lifted one hand, first to his forehead and then to his heart, in a delicate gesture of consummate gallantry.]
roulade = a florid passage of runs in classical music for a solo virtuoso, especially one sung to one syllable. [ sh :I allowed myself to be drawn by the soft pleading of the waves, and the roulade of her voice]



