feral = (especially of an animal) in a wild state
primeval = of the earliest time in history
timpani = kettledrums, especially when played by one musician in an orchestra.
maim = wound or injure (a person or animal) so that part of the body is permanently damaged.
maul = (of an animal) wound (a person or animal) by scratching and tearing.
crescendo = a gradual increase in loudness in a piece of music.
discordant = harsh and jarring because of a lack of harmony.
Vicious = deliberately cruel or violent.
meek = quiet, gentle, and easily imposed on; submissive.
savage = (of an animal or force of nature) fierce, violent, and uncontrolled.
multitudinous = very numerous.
cower = crouch down in fear.
actuary = a person who compiles and analyses statistics and uses them to calculate insurance risks and premiums.
snicker = give a smothered or half-suppressed laugh; snigger.
thespian = relating to drama and the theatre.
complacency = a feeling of smug or uncritical satisfaction with oneself or one's achievements.
parkour = the sport of traversing environmental obstacles by running, climbing, or leaping rapidly and efficiently.
yap = give a sharp, shrill bark.
twitch = give or cause to give a short, sudden jerking or convulsive movement.
hind =  situated at the back; posterior.
unsheathe = draw or pull out (a knife, sword, or similar weapon) from its sheath or covering.
scorching = very hot.
frigid = very cold in temperature.
podium = a small platform on which a person may stand to be seen by an audience, as when making a speech or conducting an orchestra.
glee = great delight, especially from one's own good fortune or another's misfortune.
cribbage = a card game, usually for two players, in which the objective is to play so that the pip value of one's cards played reaches exactly 15 or 31.
deterrent = a thing that discourages or is intended to discourage someone from doing something.
cripes = used as a euphemism for Christ.
recede = go or move back or further away from a previous position.
borough = a town or district which is an administrative unit, in particular:
whip = move fast or suddenly in a specified direction.
delouse = treat (a person or animal) to rid them of lice and other parasitic insects.
mayhem = violent or extreme disorder; chaos.
perp = the perpetrator of a crime.
muzzle = the projecting part of the face, including the nose and mouth, of an animal such as a dog or horse.
pudgy =  rather fat.
cram = completely fill (a place or container) to the point of overflowing.
wistful = having or showing a feeling of vague or regretful longing.
gruff = (of a voice) rough and low in pitch.
dais = a low platform for a lectern or throne.
stomp = tread heavily and noisily, typically in order to show anger.
steely = coldly determined; hard.
slinks = move smoothly and quietly with gliding steps, in a stealthy or sensuous manner.
skulk = move stealthily or furtively.
holster = a holder for carrying a handgun or other firearm, typically made of leather and worn on a belt or under the arm.
goofy = foolish or harmlessly eccentric.
stinker = a person or thing that smells very bad.
snot = nasal mucus. OR a contemptible or worthless person.
mucous = relating to, producing, covered with, or of the nature of mucus.


